1111111111111
10010000000C1
10000101110C1
1P0011E000011
1111111111111